##    #
## ## #
# B   #
# ## ##
    A##
#######
