###  B#
##  # #
## #  #
## # ##
A    ##
 ######
